BBBBBBBBBBBBBBBBBBBBBBBBBBBBBBBBBBBBBBBBBBBBBBBBBBBBBBBBBBBBBBBBBBBBBBBBBBBBBBBBBBBBBBBBBBBBBBBBBBBB
BMMMMMMMMMMMMMMMMMMMMMMMMMMMMMMMMMMMMMMMMMMMMMMMMMMMMMMMMMMMMMMMMMMMMMMMMMMMMMMMMMMMMMMMMMMMMMMMMMMB
BMMMMMMMMMMMMMMMMMMMMMMMMMMMMMMMMMMMMMMMMMMMMMMMMMMMMMMMMMMMMMMMMMMMMMMMMMMMMMMMTTMMMMMMMMMMMMMMMMMB
BMMMMMTTMMMMMMMMMMMMMMMMMMMMMMMMMMMMMMMMMMMMMMMMMMMMMMMMMMMMMMMMMMMMMMMMMMMMMMMMMMMMMMMMMMMMMMMMMMMB
BMMMMMMMMMMMMMMMMMMMMTTTMMMMMMMMMMMMMMMMMMMMMMMMMMMMMMMMMMMMMMMMTTTMMMMMMMMMMMMMMMMMMMMMMMMMMMMMMMMB
BMMMMMMMMMMMMMMMMMMMMMMMMMMMMMMMMMMMMMMMMMMMMTMMMMMMMMMMMMMMMMMMMMMMMMMMMMMMMMMMMMMMMMMMMMMMMMMMMMMB
BMMMMMMMMMMMMMMMMMMMMMMMMMMMMMMMMMMMMMMMMMMMMMMMMMMMMMMMMMMMMMMMMMMMMMMMMMMMMMMMMMMTTTMMMMMMMMMMMMMB
BMMMMMMMMMMMMMMMMMMMMMMMMMMMMMMMMMMMMMMMMMMMMMMMMMMMMMMTTMMMMMMMMMMMMMMTTMMMMMMMMMMMMMMMMMMMMMMMMMMB
BMMMMMMMMTTTTTMMMMMMMMMMMMMMMMMMMMMTTTMMMMMMMMMMMMMMMMMMMMMMMMMMMMMMMMMMMMMMMMMMMMMMMMMMMMMMMMMMMMMB
BMMMMMMMMMMMMMMMMMMMMMMMMMMMMMMMMMMMMMMMMMMMMMMMMMMMMMMMMMMMMMMMMMMMMMMMMMMMMMMMMMMMMMMMMMMMMMMMMMMB
BMMMMMMMMMMMMMMMMMMMMMMMMMMMMMMMMMMMMMMMMMMMMMMMMMMMMMMMMMMMMMMMMMMMMMMMMMMMMMMMMMMMMMMMMMMMMMMMMMMB
BMMMMMMMMMMMMMMMMMMMMMMMMMMMMMMMMMMMMMMMMMMMMMMMMMMMMMMMMMMMMMMMMMGGGMMMMMMMMMMMMMMMMMMMMMMMMMMMMMMB
BMMMMMMMMMMMMMMMMMMMMMMMMMMMMMMMMMMMMMMMMMMMMMMMMMMMMMMMMMMMMMGGGGGGGGGGGMMMMMMMMMMMMMMMMMMMMMMMMMMB
BMMMMTTMMMMMMMMMMMMMMMMMMMMMMMMMMMMMMMMMMMMMMMMMMMMMMMMMGGGGGGGGGGGGGGGGGGGGGGGGMMMMMMMMMMMMMMMMMMMB
BMMMMMMMMMMMMMMMMMMMMMMMMMMVVVVMMVVVVMMMMMMMMMMMMMMMMMMMMMMMMGGGGMMMMMMMMMMMMMMMMMMMMMMMMMMMMMMMMMMB
BMMMMMMMMMMMMMMMMMMMMMMMVVVVMMMMMMBBBBBMMMMMMMMMMMMMMMMMMMMMMMMGGMMMMMMMMMMMMMMMMMMMMMMMMMMMMMMMMMMB
BMMMMMMMMMMMMMMMMMMMMMMMVVVMMMMMMMMMMMBBBBBMMMMMMMMMMMMMMMMMMMMMMMMMMMMMMMMMMTTMMMMMMMMMMMMMMMMMMMMB
BMMMMMMTTTMMMMMMMMMMMMVVVVMMMMMMMMMMMMMMMBBBBMMMMMMMMMMMMMMMMMMMMMMMMMMMMMMMMMMMMMMMMMMMMMMMMMMMMMMB
BMMMMMMMMMMMMMMMMMMMMMMMMMMMMMMMMMMTTTTTTTMMBBBBMMMMMMMMMMMMMMMMMMMMMMMMMMMMMMMMMMMMMMMMMMMMMMMMMMMB
BMMMMMMMMMMMMMMMMMMMMMMMMMMBBBBBMMMTTTTTTTTMMMMBBBBMMMMMMMMMGMMMMMMMMMMMMMMMMMMMMMMMMMMMMMMMMMMMMMMB
BMMMMMMMMMMMMMMMMMMMMMMMMMMMBBBBBMMMTTTTTTMMMMBBBMMMMMMMMMMMGMMMMMMMMMMMMMMMMMMMMMMMMMMMMMMMMMMMMMMB
BMMMMMMMMMMMMMMMMMMMMMMMMMMMMMBBBBBMMMMTTTMMBBBBBBBBMMMMMMMMGMMMMMMMMMMMMMMTTTTTMMMMMMMMMMMMMMMMMMMB
BMMMMMMMMMMMMMMMMMMMMMSSSMMMMMMMMBBBBBMMMMMBBBBMMMMMMMMMMMMMGMMMMMMMMMMMMMMMMMMMMMMMMMMMMMMMMMMMMMMB
BMMMMMMMMMMMMMMMMMMMMMSSSMMMMMMMMMMMBBBBBBBBMMMMMMMMMMMMMMMMGMMMMMMMMMMMMMMMMMMMMMMMMMMMMMMMMMMMMMMB
BMMMMMMMMMMMMMMMMMMMMMHHSMMMMMMMMMMMMMBBBBBBBMMMMMMMMMMMMMMMGMMMMMMMMMMMMMMMMMMMMMMMMMMMMMMMMMMMMMMB
BMMMMMMMMMMMMMMMMMMMMMMMMMMMMMMMMMMMMMMMMMMMMMMMMMMMMMMMMMMMGMMMMMMMMMMMMMMMMMMMMMMMMMMMMMMMMMMMMMMB
BMMMMMMMMMMMMMMMMMGGGGGGGGGMMMMMMMMMMMMMMMMMMMMMMMMMMMMMMMMMGMMMMMMMMMMMMMMMMMMMMMMMMMMMMMMMMMMMMMMB
BMMMMMMMMMGGGGGGGGGGGGGGGGGGGGGGGGGGMMMMMMMMMMMMMMMMMMMMMMMMGMMMMMMMMMMMMMMMMMMMMMMMMMMMMMMMMMMMMMMB
BMMMMMMMMMMMMMMMMMMGGGGGGGMMMMMMMMMMMMMMMMMMMMMMMMMMMMMMGGGGGGGGGGGGGGGGGGGGGGMMMMMMMMMMMMMMMMMMMMMB
BMMMMMMMMMMMMMMMMMMMMGGGGMMMMMMMMMMMMMMMMMMMMMMMMMMMMMMMMMMMMMMMMMMMMGGGGGGGGMMMMMMMMMMMMMMMMMMMMMMB
BMMMMMMMMMMMMMMMMMMMMMMGMMMMMMMMMMMMMMMMMMMMMGGGGGGGGMMMMMMMMMMMMMMMMMMMMMMMMMMMMMMMMMMMMMMMMMMMMMMB
BMMMMMMMMMMMMMMMMMMMMMMGMMMMMMMMMMMMMMMMMMMMMMMMMMMMMMMMMMMMMMMMMMMMMMMMMMMMMMMMMMMMMMMMMMMMMMMMMMMB
BMMMMMMMMMMMMMMMMMMMMMMGMMMMMMMMMMMMMMMMMMMMMMMMMMMMMMMMMMMMMMMMMMMMMMMMMMMMMMMMMMMMMMMMMMMMMMMMMMMB
BMMMMMMMMMMMMMMMMMMMMMMMMMMMMMMMMMMMMMMMMMMMMMMMMMMMMMMMMMMMMMMMMMMMMMMMMMMMMMMMMMMMMMMMMMMMMMMMMMMB
BMMMMMMMMMMMMMMMMMMMMMMMMMMMMMMMMMMMMMMMMMMMMMMMMMMMMMMMMMMMMMMMMMMMMMMMMMMMMMMMMMMMMMMMMMMMMMMMMMMB
BMMMMMMMMMMMMMMMMMMMMMMMMMMMMMMMMMMMMMMMMMBBBBBBBBBBBBBBBBBBBBBBBBBBBBBBBBBBBBBBBBBBBBBBBBMMMMMMMMMB
BMMMMMMMMMMMMMMMMMMMMMMMMMMMMMMMMMMMMMMMMMMMMMMMMMMMMMMMMMMMMMMMMMMMMMMMMMMMMMMMMMMMMMMMMMMMMMMMMMMB
BMMMMMMTTTTTTTTTMMMMMMMMMMMMMMMMMMMMMMMMMMMMMMMMMMMMMMMMMMMMMMMMMMMMMMMMMMMMMMMMMMMMMMMMMMMMMMMMMMMB
BMMMMMMTTTTTTTTTTMMMMMMMMMMMMMMMMMMMMMMMMMMMMMMMMMMMMMMMMMMMMMMMMMMMMMMMMMMMMMMMMMMMMMMMMMMMMMMMMMMB
BMMMMMMTTTTTTTTTTMMMMMMMMMMMMMMMMMMMMBBBBMMMMMMMMMMMMMMMMMMMMMTTTTTTTTMMMMMMMMMMMMMMMMMMMMMMMMMMMMMB
BMMMMMMTTTTTTTTTTMMMMMMMMMMMMMMMMMMMMMMGMMMMMMMMMMMMMMMMMMMMMMMMMMMMMMMMMMMMMMMMMMMMMMMMMMMMMMMMMMMB
BMMMMMMMMMMMMMMMMMMMMMMMMMMMMMMMMMMMMBBBMMMMMMMMMMMMMMMMMMMMMMMMMMMMMMMMMMMMMMMMMMMMMMMMMMMMMMMMMMMB
BMMMMMMMMMMMMMMMMMMMMMMMMMMMMMMMMMMMMMGMMMMMMMMMMMMMMMMMMMMMMMMMMMMMMMMMMMMMMMMMMMMMMMMMMMMMMMMMMMMB
BMMMMMMMMMMMMMMMMMMMMMMMMMMMMMMMMMMMMBBBBMMMMMMMMMMMMMMMMMMMMMMMMMMMMMMMMMMMMMMMMMMMMMMMMMMMMMMMMMMB
BMMMMMMMMMMMMMMMMMMMMMMMMMMMMMMMMMMMMBBBMMMMMMMMMMMMMMMMMMMMMMMMMMMMMMMMMMMMMMMMMMMMMMMMMMMMMMMMMMMB
BMMMMMMMMMMMMMMMMMMMMMMMMMMMMMMMMMMMMMMMMMMMMMMMMMMMMMMMMMMMMMMMMMMMMMMMMMMMMMMMMMMMMMMMMMMMMMMMMMMB
BMMMMMMMMMMMMMMMMMMMMMMMMMMMMMMMMMMMMMMMMMMMMMMMMMMMMMMMMMMMMMMMMMMMMMMMMMMMMMMMMMMMMMMMMMMMMMMMMMMB
BMMMMMMMMMMMMMMMMMMMMMMMMMMMMMMMMMMMMMMMMMMMMMMMMMMMMMMMMMMMMMMMMMMMMMMMMMMMMMMMMMMMMMMMMMMMMMMMMMMB
BMMMMMMMMMMMMMMMMMMMMMMMMMMMMMMMMMMMMMMMMMMMMMMMMMMMMMMMMMMMMMMMMMMMMMMMMMMMMMMMMMMMMMMMMMMMMMMMMMMB
BMMMMMMMMMMMMMMMMMMMMMMMMMMMMMMMMMMMMMMMMMMMMMMMMMMMMMMMMMMMMMMMMMMMMMMMMMMMMMMMMMMTTTTTMMMMMMMMMMMB
BMMMMMMMMMMMMMMMMMMMMMMMMMMMMMMMMMMMMMMMMVVVVVVVVVVVVVVMMMMMMMMMMMMMMMMMMMMMMMMMMMMMMMTTTMMMMMMMMMMB
BGGGGGGMMMMMMMMMMMMMMMMMMMMMMMMMMMMMMMMMMMMMVVVVVVVVVVVVVVVVVMMMMMMMMMMMMMMMMMMMMTTTTTMMMMMMMMMMMMMB
BMMMMVVVVVVVVVVVVVVMMMMMMMMMMMMMMMMMMMMMMMMMMMMVVVVVVVVVVVVVVVVVMMMMMMMMMMMMMMMMMMTTTMMMMMMMMMMMMMMB
BMMMMMMMMMMMMMMMMMVMMMMMMMMMMMMMMMMMMMMMMMMMMMMMVVVVVVMMMMMMMMMMMMMMMMMMMMMMMMMMMMMMMMMMMMMMMMMMMMMB
BVVVVVVVVVMMMMMMMMVMMMMMMMMTTTTTMMMMMMMMMMMMMMMMVVVVVVMMMMMMMMMMMMMMMMMMMMMMMMMMMMMMMMTTTTMMMMMMMMMB
BTTTTTTTTTMMMMMMMMVMMMMMMMMMMMMMMMMMMMMMMMMMMMMMMVVVVVMMMMMMMMMMMMMMMMMMMMMMMMMMMMMMMMMMMMMMMMMMMMMB
BTTTTTTTTTMMMMMMMMVMMMMMMMMMMMMMMMMMMMMMMMMMMMMMMMGGMMMMMMMMMMMMMMMMMMMMMMMMMMMMMMMMMMMMMMMMMMMMMMMB
BTTTTTTTTTMMMMMMMMVMMMMMMMMMMMMMMMMMMMMMMMMMMMMVVVVVVVVMMMMMMMMMMMMMMMMMMMMMMMMMMMMMMMMMMMMMMMMMMMMB
BTTTTTTTTTMMMMMMMMVMMMMMMMMMMMMMMMMMMMMMMMMMVVVVMMMMMMVVVVVVVVVVVVVVVVVVVMMMMMMMMMMMMMMMMMMMMMMMMMMB
BVVVVVVVVVMMMMMMMMVMMMMMMMMMMMMMMMMMMMMMMMMMMMVVVVVVVVVVVVMMMMMMMMMMMMMMMMMMMMMMMMMMMMMMMMMMMMMMMMMB
BMMMMMMMMMMMMMMMMMVMMMMMMMMMMMMMMMMMMMMMMMMMMMMMVVVVMMMMMMMMMMMMMMMMMMMMMMMMMMMMMMMMMMMMMMMMMMMMMMMB
BMMMMVVVVVVVVVVVVVVMMMMMMMMMMMMMMMMMMMMMMMMMMMMMMVVVVMMMMMMMMMMMMMMMMMBBMMTTTMMMMMMMMMMMMMMMMMMMMMMB
BGGGGGMMMMMMMMMMMMMMMMMMMMMMMMMMMMMMMMMMMMMMMMMMMMVVMMMMMMMMMMMMMMTTTTMMMMMMMMMMMMMMMMMBBBBBMMMMMMMB
BMMMMMMMMMMMMMMMMMMMMMMMMMMMMMMMMMMMMMMMMMMMMMMMMVVVMMMMMMMMMMMMMMMMMMMMBBBBMMMMMMMMMMMMMMMMMMMMMMMB
BMMMMMMMMMMMMMMMMMMMMMMMMMMMMMMMMMMMMMMMMMMMMMMMMMMMMMMMMMMMMMMMMMMMMMMMMMBBBBMMMMMMMMMMMMMMMMMMMMMB
BMMMMMMMMMMMMTTTTTTMMMMMMMMMMMMTTMMMMMMMMMMMMMMMMTTTMMMMMBBBBMMMMMMMBBBMMMMMMMMMMMMTTTMMMMMMMMMMMMMB
BMMMMMMMMMMMMMMTTTMMMMMMMMMMMMMMMMMMMMMMMMMMMMMMMMMMMMMMMMMMMMMMMMMMMMMMMMMMMMMMMMMMMMMMMMMMMMMMMMMB
BMMMMMMMMMMMMMMMTTTMMMMMMMMMMMMMMMMMMMMMMMMMMMMMMMMMMMMMMMMMMMMMMMMMMMMMMMMMMMMMMMMMMMMMMMMMMMMMMMMB
BMMMMMMMMMMMMMMMTTTMMMMMMMMMMMMMMMMMMMMMMMMMMMMMMMMMMMMMMMMMMMMMMMMMMGGGMMMMMMMMMMMMMMMMMMMMMMMMMMMB
BMMMMMMMMMMMMMMMMMMMMMMMMMMMMMMMMMMMMMMMMMMMMMMMMMTTTMMMMMMMMMMMMGGGGGGGGGGGMMMMMMMMMMMMMMMMMMMMMMMB
BMMMMMMMMMMMMMMMMMMMMMMMMMMMMMMMMMMMMMMMMMMMMMMMMMMMMMMMGGGGGGGGGGGGGGGGGGGGGGGGMMMMMMMMMMMMMMMMMMMB
BMMMMMMMMMMMMMMMMMMMMMMMMMMVVVVMMVVVVMMMMMMMMMMMMMMMMMMMMMMMMGGGGMMMMMMMMMMMMMMMMMMMMMMMMMMMMMMMMMMB
BMMMMMMMMMMMMMMMMMMMMMMMVVVVMMMMMMBBBBBMMMMMMMMMMMMMMMMMMMMMMMMGGMMMMMMMMMMMMMMMMMMMMMMMMMMMMMMMMMMB
BMMMMMMMMMMMMMMMMMMMMMMMVVVMMMMMMMMMMMBBBBBMMMMMMMMMMMMMMMMMMMMMMMMMMMMMMMMMMMMMMMMMMMMMMMMMMMMMMMMB
BMMMMMMMMMMMMMMMMMMMMMVVVVMMMMMMMMMMMMMMMBBBBMMMMMMMMMMMMMMMMMMMMMMMMMMMMMMMMMMMMMMMMMMMMMMMMMMMMMMB
BMMMMMTTTTTMMMMMMMMMMMMMMMMMMMMMMMMTTTTTTTMMBBBBMMMMMMMMMMMMMMMMMMMMMMMMMMMMMMMMMMMMMMMMMMMMMMMMMMMB
BMMMMMMMMMMMMMMMMMMMMMMMMMMBBBBBMMMTTTTTTTTMMMMBBBBMMMMMMMMMMMMMMMMMMMMMMMMMMMMMMMMMMMMMMMMMMMMMMMMB
BMMMMMMMMMMMMMMMMMMMMMMMMMMMBBBBBMMMTTTTTTMMMMBBBMMMMMMMMMMMMMMMMMMMMMMMMMMMMMMMMMMMMMMMMMMMMMMMMMMB
BMMMMMMMMMMMMMMMMMMMMMMMMMMMMMBBBBBMMMMTTTMMBBBBBBBBMMMMMMMMMMMMMMMMMMMMMMMTTTTTMMMMMMMMMMMMMMMMMMMB
BMMMMMMMMMMMMMMMMMMMMMMMMMMMMMMMMBBBBBMMMMMBBBBMMMMMMMMMMMMMMMMMMMMMMMMMMMMMMMMMMMMMMMMMMGGGGGMMMMMB
BMMMMMMMMMMMMMMMMMMMMMMMMMMMMMMMMMMMBBBBBBBBMMMMMMMMMMMMMMMMMMMMMMMMMMMMMMMMMMMMMMMMMMMMMMMMMMMMMMMB
BMMMMMMMMMMMMMMMMMMMMMMMMMMMMMMMMMMMMMBBBBBBBMMMMMMMMMMMMMMMMMMMMMMMMMMMMMMMMMMMMMMMMMMMMMMMMMMMMMMB
BMMMMMMMMMMMMMMMMMMMMMMMMMMMMMMMMMMMMGGGGGGGGGGGGGGGGGGMMMMMMMMMMMMMMMMMMMMMMMMMMGGGGGGGGGGGGGGGGGGB
BMMMMMMMMMMMMMMMMMGGGGGGGGGMMMMMMMMMMMMMMMMMMMMMMMMMMMMMMMMMMMMMMMMMMMMMMMMMMMMMMMMMMMMMMMMMMMMMMMMB
BGGGGGGGGGGGGGGGGGGGGGGGGGGGGGGGGGGGMMMMMMMMMMMMMMGGGGGGGGGGGGGGGGGGGGGGGGGGGGMMMMMMMMMMMMMMMMMMMMMB
BMMMMMMMMMMMMMMMMMMGGGGGGGGGGGGGGGGGGGGGGGGGGGGGGGGGGGGGGGGGGGGGGGGGGGGGGGGGGGGGGGGGGGGGGGGGGGGGGGGB
BMMMMMMMMMMMMMMMMMMMMGGGGMMMMMMMMMMMMMMMMMMMMMMMGMMMMMMMMMMMMMMMMMMMMGGGGGGGGMMMMMMMMMMMMMMMMMMMMMMB
BMMMMMMMMMMMMMMMMMMMMMMGMMMMMMMMMMMMMMMMMMMMMGGGGGGGGMMMMMMMMMMMMMMMMMMGGMMMMMMMMMMMMMMMMMMMMMMMMMMB
BMMMMMMMMMMMMMMMMMMMMMMGMMMMMMMMMMMMMMMMMMMMMMMGMMMMMMMMMMMMMMMMMMMMMMMGGMMMMMMMMMMMMMMMMMMMMMMMMMMB
BMMMMMMMMMMMMMMMMMMMMMMGMMMMMMMMMMMMMMMMMMMMMMMGMMMMMMMMMMMMMMMMMMMMMMMMGGMMMMMMMMMMMMMMMMMMMMMMMMMB
BMMMMMMMMMMMMMMMMMMMMMMMMMMMMMMMMMMMMMMMMMMMMMMGMMMMMMMMMMMMMMMMMMMMMMMMMGGMMMMMMMMMMMMMMMMMMMMMMMMB
BTTTTTTTTTTTTTTTTTTTTTTTTTTTTTTTTTTTTTTTTTTTTTTTTTTTTTTTTTTTTTTTTTTTTTTTTTTTTTTTTTTTTTTTTTTTTTTTTTTB
BTTTTTTTTTTTTTTTTTTTTTTTTTTTTTTTTTTTTTTTTTTTTTTTTTTTTTTTTTTTTTTTTTTTTTTTTTTTTTTTTTTTTTTTTTTTTTTTTTTB
BTTTTTTTTTTTTTTTTTTTTTTTTTTTTTTTTTTTTTTTTTTTTTTTTTTTTTTTTTTTTTTTTTTTTTTTTTTTTTTTTTTTTTTTTTTTTTTTTTTB
BTTTTTTTTTTTTTTTTTTTTTTTTTTTTTTTTTTTTTTTTTTTTTTTTTTTTTTTTTTTTTTTTTTTTTTTTTTTTTTTTTTTTTTTTTTTTTTTTTTB
BTTTTTTTTTTTTTTTTTTTTTTTTTTTTTTTTTTTTTTTTTTTTTTTTTTTTTTTTTTTTTTTTTTTTTTTTTTTTTTTTTTTTTTTTTTTTTTTTTTB
BMMMMMMMMMMMMMMMMMMMMMMMMMMMMMMMMMMMMMMMMMMMMMMMMMMMMMMMMMMMMMMMMMMMMMMMMMMMMMMMMMMMMMMMMMMMMMMMMMMB
BMMMMMMMMMMMMMMMMMMMMMMMMMMMMMMMMMMMMMMMMMMMMMMMMMMMMMMMMMMMMMMMMMMMMMMMMMMMMMMMMMMMMMMMMMMMMMMMMMMB
BMMMMMMMMMMMMMMMMMMMMMMMMMMMMMMMMMMMMMMMMMMMMMMMMMMMMMMMMMMMMMMMMMMMMMMMMMMMMMMMMMMMMMMMMMMMMMMMMMMB
BBBBBBBBBBBBBBBBBBBBBBBBBBBBBBBBBBBBBBBBBBBBBBBBBBBBBBBBBBBBBBBBBBBBBBBBBBBBBBBBBBBBBBBBBBBBBBBBBBBB

